NO ./textures/meruem.png
WE ./textures/killua.png
SO ./textures/hisoka_portrait.png
EA ./textures/chrollo_portrait.png

F        0,0,0
C        36,26,0              

11111111111111111111111111111111111111111111111111111111111111111
10000000000000000000000000000000000000000000000000000000000000001
11111111111111111111111111101111111111111111111111111111111111111
                          101
                          101
                          101
                          101
                          101                                                               1111
111111111111111111111111111011111111111111111111111111111111111111                           1001
100000000000000000110000000000000000000000000000000000000000000001                            1001
100000000011000001110000000000001111111111101111111111111111111011                             1001
100000000001000000000000000000001       100001               1001                               1001
111111111011000001110000W00000001      10011001             1001                                 1001
100000000011000001110111111011111     1001  1001           1001                                   1001
11110111111111011 100000000001       1001    1001         1001                                     1001
111101111111110111101000000001      1001      1001       1001                                       1001
100000000000000000000000000001     1001        1001     1001                                         1001
1000000000000000010001000100001   1001          1001   1001                                           1001
10000000000000011110001000000101 1001            1001 1001                                             1001
11000001110101001 101010100001001001              1001001                                               1001
11110111 1110101 100000000000000001                10001                                                 1001
11111111 1110111 11111111111111111                  111                                                   1001
           101                                                                                             1001
           101                                                                                              1001
           101                                                                                               1001
           101                                                                                                1001
           101                                                                                                 1001
           101                                                                                                  1001
           1011111111111111111111111111111111111111111111111111111111111111111111111111111111111111111111111111111001
           10000000000000000000000000000000000000000000000000000000000000000000000000000000000000000000000000000000001
           11111111111111111111111111111111111111111111111111111111111111111111111111111111111111111111111111111111111