NO ./textures/ronda_1.png
SO ./textures/ronda_1.png
WE ./textures/ronda_1.png
EA ./textures/ronda_1.png

F 220,100,0
C 251,255,2

111111111111111111111111
100000000000000000000001
100000000000000000000001
100000000000000000000001
10000000000W000000000001
111111111111111111111111