F    5,115,9
C    212,204,181

NO           ./texture/file1.png
SO           ./texture/file4.png
WE           ./texture/file2.png
EA           ./texture/file3.png


111111111111111111111111111111
100000000000000000000000010001
100000000000000000000000111001
100100000000000000000000010001
100100000000000000000000000001
100100011111111111110000000001
100100000000000000000000000001
100100000000000000000000000001
100100000000000000000000000001
100000000000000000000000000001
100000100000000000000000000001
100000010000000W00000000000001
100000010000000000000000000001
100000000000000000000000000001
111111111111111111111111111111